Rk,Tm,Season,G,W,L,W/L%,MP,TeamFG,TeamFGA,TeamFG%,Team2P,Team2PA,Team2P%,Team3P,Team3PA,Team3P%,TeamFT,TeamFTA,TeamFT%,TeamPTS,OpponentFG,OpponentFGA,OpponentFG%,Opponent2P,Opponent2PA,Opponent2P%,Opponent3P,Opponent3PA,Opponent3P%,OpponentFT,OpponentFTA,OpponentFT%,OpponentPTS
1,ATL,2019-20,11,4,7,.364,2665,439,954,.460,332,599,.554,107,355,.301,192,272,.706,1177,433,971,.446,303,581,.522,130,390,.333,233,297,.785,1229
2,GSW,2019-20,12,2,10,.167,2905,475,1091,.435,352,715,.492,123,376,.327,250,291,.859,1323,540,1097,.492,377,680,.554,163,417,.391,210,277,.758,1453
3,HOU,2019-20,11,8,3,.727,2640,441,999,.441,270,490,.551,171,509,.336,252,328,.768,1305,473,1039,.455,325,631,.515,148,408,.363,183,245,.747,1277
4,MIL,2019-20,11,8,3,.727,2665,476,1006,.473,323,553,.584,153,453,.338,218,303,.719,1323,428,1027,.417,264,587,.450,164,440,.373,213,279,.763,1233
5,BRK,2019-20,11,4,7,.364,2690,466,1018,.458,322,620,.519,144,398,.362,209,284,.736,1285,487,1064,.458,353,699,.505,134,365,.367,207,267,.775,1315
6,MIN,2019-20,11,7,4,.636,2715,463,1052,.440,328,615,.533,135,437,.309,228,300,.760,1289,472,1019,.463,343,686,.500,129,333,.387,205,277,.740,1278
7,CHI,2019-20,12,4,8,.333,2880,468,1082,.433,327,659,.496,141,423,.333,212,287,.739,1289,474,1028,.461,341,633,.539,133,395,.337,245,333,.736,1326
8,CHO,2019-20,11,4,7,.364,2665,427,948,.450,289,574,.503,138,374,.369,183,254,.720,1175,484,980,.494,354,615,.576,130,365,.356,153,198,.773,1251
9,DAL,2019-20,11,6,5,.545,2665,446,987,.452,299,552,.542,147,435,.338,217,286,.759,1256,465,1005,.463,332,636,.522,133,369,.360,166,224,.741,1229
10,WAS,2019-20,9,2,7,.222,2160,392,851,.461,283,535,.529,109,316,.345,147,178,.826,1040,392,826,.475,279,526,.530,113,300,.377,183,229,.799,1080
11,DET,2019-20,12,4,8,.333,2880,467,996,.469,325,643,.505,142,353,.402,231,304,.760,1307,510,1046,.488,381,705,.540,129,341,.378,201,257,.782,1350
12,IND,2019-20,11,7,4,.636,2665,475,1003,.474,383,736,.520,92,267,.345,162,194,.835,1204,415,943,.440,293,607,.483,122,336,.363,192,257,.747,1144
13,MEM,2019-20,11,4,7,.364,2665,464,1006,.461,353,674,.524,111,332,.334,171,224,.763,1210,467,1009,.463,326,613,.532,141,396,.356,232,293,.792,1307
14,MIA,2019-20,11,8,3,.727,2665,437,923,.473,298,562,.530,139,361,.385,212,287,.739,1225,412,946,.436,294,534,.551,118,412,.286,212,292,.726,1154
15,CLE,2019-20,11,4,7,.364,2640,421,967,.435,310,618,.502,111,349,.318,205,257,.798,1158,459,980,.468,336,617,.545,123,363,.339,137,183,.749,1178
16,ORL,2019-20,11,4,7,.364,2640,408,969,.421,311,629,.494,97,340,.285,180,229,.786,1093,407,943,.432,295,591,.499,112,352,.318,164,218,.752,1090
17,BOS,2019-20,10,9,1,.900,2400,417,912,.457,287,561,.512,130,351,.370,197,249,.791,1161,379,885,.428,264,545,.484,115,340,.338,196,260,.754,1069
18,PHI,2019-20,11,7,4,.636,2640,452,978,.462,341,640,.533,111,338,.328,179,244,.734,1194,422,918,.460,312,619,.504,110,299,.368,211,299,.706,1165
19,PHO,2019-20,11,7,4,.636,2665,461,970,.475,311,583,.533,150,387,.388,222,276,.804,1294,437,953,.459,328,631,.520,109,322,.339,233,307,.759,1216
20,SAC,2019-20,10,4,6,.400,2400,385,868,.444,255,518,.492,130,350,.371,156,209,.746,1056,411,838,.490,295,524,.563,116,314,.369,165,218,.757,1103
21,DEN,2019-20,11,8,3,.727,2690,431,1003,.430,319,675,.473,112,328,.341,178,234,.761,1152,409,960,.426,297,596,.498,112,364,.308,191,263,.726,1121
22,POR,2019-20,12,4,8,.333,2905,488,1106,.441,343,701,.489,145,405,.358,225,276,.815,1346,480,1094,.439,346,702,.493,134,392,.342,273,340,.803,1367
23,NYK,2019-20,12,3,9,.250,2880,436,1040,.419,307,683,.449,129,357,.361,199,303,.657,1200,462,1002,.461,318,592,.537,144,410,.351,248,320,.775,1316
24,SAS,2019-20,11,5,6,.455,2640,460,996,.462,364,714,.510,96,282,.340,220,281,.783,1236,472,993,.475,355,668,.531,117,325,.360,195,251,.777,1256
25,OKC,2019-20,11,4,7,.364,2640,420,930,.452,299,598,.500,121,332,.364,197,261,.755,1158,440,987,.446,343,663,.517,97,324,.299,189,230,.822,1166
26,UTA,2019-20,11,8,3,.727,2640,408,886,.460,289,567,.510,119,319,.373,215,286,.752,1150,398,947,.420,298,621,.480,100,326,.307,199,261,.762,1095
27,LAC,2019-20,12,7,5,.583,2880,484,1057,.458,366,701,.522,118,356,.331,253,328,.771,1339,461,1062,.434,302,635,.476,159,427,.372,222,294,.755,1303
28,LAL,2019-20,11,9,2,.818,2665,474,992,.478,372,680,.547,102,312,.327,169,228,.741,1219,403,956,.422,290,594,.488,113,362,.312,191,246,.776,1110
29,NOP,2019-20,11,3,8,.273,2665,479,1038,.461,317,605,.524,162,433,.374,182,255,.714,1302,481,1015,.474,334,608,.549,147,407,.361,242,306,.791,1351
30,TOR,2019-20,11,8,3,.727,2665,438,955,.459,283,565,.501,155,390,.397,208,247,.842,1239,425,1050,.405,280,626,.447,145,424,.342,178,234,.761,1173
31,CHI,2018-19,20,5,15,.250,4875,766,1741,.440,563,1162,.485,203,579,.351,333,428,.778,2068,838,1842,.455,596,1149,.519,242,693,.349,341,429,.795,2259
32,LAL,2018-19,20,11,9,.550,4825,863,1820,.474,657,1226,.536,206,594,.347,323,452,.715,2255,851,1874,.454,631,1257,.502,220,617,.357,337,415,.812,2259
33,POR,2018-19,20,12,8,.600,4825,822,1821,.451,595,1174,.507,227,647,.351,382,460,.830,2253,837,1865,.449,608,1227,.496,229,638,.359,310,426,.728,2213
34,WAS,2018-19,20,8,12,.400,4850,817,1777,.460,607,1123,.541,210,654,.321,422,557,.758,2266,855,1803,.474,608,1157,.525,247,646,.382,401,507,.791,2358
35,CHO,2018-19,20,10,10,.500,4850,843,1829,.461,590,1136,.519,253,693,.365,365,454,.804,2304,817,1783,.458,589,1108,.532,228,675,.338,353,449,.786,2215
36,MIL,2018-19,20,14,6,.700,4825,894,1835,.487,602,1020,.590,292,815,.358,340,445,.764,2420,819,1866,.439,570,1155,.494,249,711,.350,312,423,.738,2199
37,BRK,2018-19,20,8,12,.400,4825,795,1788,.445,550,1090,.505,245,698,.351,353,484,.729,2188,812,1758,.462,639,1255,.509,173,503,.344,418,530,.789,2215
38,DET,2018-19,20,13,7,.650,4900,808,1844,.438,582,1159,.502,226,685,.330,389,529,.735,2231,799,1730,.462,621,1160,.535,178,570,.312,407,523,.778,2183
39,HOU,2018-19,20,9,11,.450,4850,761,1713,.444,477,874,.546,284,839,.338,358,481,.744,2164,801,1679,.477,605,1130,.535,196,549,.357,407,521,.781,2205
40,NOP,2018-19,20,10,10,.500,4800,888,1858,.478,692,1299,.533,196,559,.351,403,534,.755,2375,866,1854,.467,627,1205,.520,239,649,.368,374,484,.773,2345
41,IND,2018-19,20,12,8,.600,4800,829,1713,.484,642,1212,.530,187,501,.373,282,394,.716,2127,738,1662,.444,493,1021,.483,245,641,.382,321,411,.781,2042
42,MEM,2018-19,20,12,8,.600,4850,755,1655,.456,552,1100,.502,203,555,.366,358,476,.752,2071,728,1619,.450,517,1029,.502,211,590,.358,373,488,.764,2040
43,DEN,2018-19,20,13,7,.650,4825,833,1793,.465,628,1190,.528,205,603,.340,328,440,.745,2199,755,1688,.447,553,1063,.520,202,625,.323,351,476,.737,2063
44,LAC,2018-19,20,14,6,.700,4875,831,1772,.469,640,1269,.504,191,503,.380,482,593,.813,2335,818,1879,.435,621,1285,.483,197,594,.332,403,519,.776,2236
45,ATL,2018-19,20,4,16,.200,4800,791,1785,.443,564,1075,.525,227,710,.320,344,468,.735,2153,851,1821,.467,588,1134,.519,263,687,.383,406,543,.748,2371
46,NYK,2018-19,20,6,14,.300,4850,805,1814,.444,609,1230,.495,196,584,.336,372,479,.777,2178,837,1778,.471,604,1132,.534,233,646,.361,379,499,.760,2286
47,MIA,2018-19,20,7,13,.350,4825,780,1795,.435,539,1127,.478,241,668,.361,371,526,.705,2172,799,1786,.447,582,1189,.489,217,597,.363,395,523,.755,2210
48,ORL,2018-19,20,10,10,.500,4800,808,1790,.451,592,1156,.512,216,634,.341,281,361,.778,2113,807,1742,.463,591,1139,.519,216,603,.358,341,439,.777,2171
49,DAL,2018-19,20,10,10,.500,4825,790,1709,.462,548,1034,.530,242,675,.359,391,522,.749,2213,805,1735,.464,583,1113,.524,222,622,.357,344,446,.771,2176
50,PHO,2018-19,20,4,16,.200,4825,785,1693,.464,577,1083,.533,208,610,.341,310,400,.775,2088,836,1735,.482,639,1155,.553,197,580,.340,412,536,.769,2281
51,SAC,2018-19,20,10,10,.500,4800,874,1836,.476,659,1279,.515,215,557,.386,320,464,.690,2283,853,1833,.465,611,1112,.549,242,721,.336,386,519,.744,2334
52,UTA,2018-19,20,9,11,.450,4800,761,1671,.455,557,1037,.537,204,634,.322,402,563,.714,2128,814,1704,.478,616,1153,.534,198,551,.359,340,467,.728,2166
53,MIN,2018-19,20,9,11,.450,4800,795,1819,.437,582,1224,.475,213,595,.358,384,467,.822,2187,831,1820,.457,586,1148,.510,245,672,.365,333,443,.752,2240
54,SAS,2018-19,20,10,10,.500,4850,817,1802,.453,628,1311,.479,189,491,.385,369,456,.809,2192,852,1786,.477,645,1195,.540,207,591,.350,290,388,.747,2201
55,CLE,2018-19,20,4,16,.200,4800,785,1756,.447,612,1278,.479,173,478,.362,327,415,.788,2070,830,1702,.488,610,1083,.563,220,619,.355,329,437,.753,2209
56,TOR,2018-19,20,16,4,.800,4825,882,1812,.487,652,1142,.571,230,670,.343,333,420,.793,2327,807,1829,.441,604,1211,.499,203,618,.328,332,443,.749,2149
57,BOS,2018-19,20,10,10,.500,4850,788,1803,.437,543,1088,.499,245,715,.343,305,395,.772,2126,773,1752,.441,562,1089,.516,211,663,.318,327,447,.732,2084
58,PHI,2018-19,20,13,7,.650,4900,797,1755,.454,577,1118,.516,220,637,.345,458,590,.776,2272,830,1887,.440,618,1256,.492,212,631,.336,393,518,.759,2265
59,GSW,2018-19,20,13,7,.650,4825,868,1750,.496,639,1165,.548,229,585,.391,353,435,.811,2318,812,1814,.448,587,1125,.522,225,689,.327,359,496,.724,2208
60,OKC,2018-19,20,13,7,.650,4800,832,1868,.445,638,1237,.516,194,631,.307,349,493,.708,2207,776,1738,.446,585,1151,.508,191,587,.325,344,446,.771,2087
61,LAC,2017-18,20,8,12,.400,4825,767,1684,.455,556,1091,.510,211,593,.356,374,494,.757,2119,781,1683,.464,565,1114,.507,216,569,.380,366,471,.777,2144
62,LAL,2017-18,20,8,12,.400,4825,810,1771,.457,647,1250,.518,163,521,.313,332,472,.703,2115,811,1805,.449,619,1216,.509,192,589,.326,341,451,.756,2155
63,NYK,2017-18,20,10,10,.500,4800,795,1709,.465,625,1228,.509,170,481,.353,320,403,.794,2080,749,1700,.441,497,1028,.483,252,672,.375,343,436,.787,2093
64,OKC,2017-18,20,8,12,.400,4800,753,1724,.437,537,1100,.488,216,624,.346,324,443,.731,2046,716,1603,.447,508,1018,.499,208,585,.356,345,446,.774,1985
65,CHI,2017-18,20,3,17,.150,4825,721,1758,.410,505,1129,.447,216,629,.343,249,327,.761,1907,785,1688,.465,553,1087,.509,232,601,.386,337,426,.791,2139
66,TOR,2017-18,20,13,7,.650,4800,820,1682,.488,596,1048,.569,224,634,.353,344,440,.782,2208,747,1671,.447,556,1152,.483,191,519,.368,377,485,.777,2062
67,MIL,2017-18,20,11,9,.550,4825,784,1634,.480,603,1137,.530,181,497,.364,309,420,.736,2058,740,1613,.459,528,1079,.489,212,534,.397,386,499,.774,2078
68,ATL,2017-18,20,4,16,.200,4800,772,1706,.453,560,1151,.487,212,555,.382,288,364,.791,2044,803,1706,.471,569,1057,.538,234,649,.361,324,429,.755,2164
69,DAL,2017-18,20,5,15,.250,4825,724,1701,.426,491,1035,.474,233,666,.350,295,386,.764,1976,745,1618,.460,521,1006,.518,224,612,.366,366,468,.782,2080
70,CHO,2017-18,20,8,12,.400,4825,754,1703,.443,566,1180,.480,188,523,.359,419,585,.716,2115,799,1787,.447,578,1149,.503,221,638,.346,323,397,.814,2142
71,DET,2017-18,20,14,6,.700,4800,806,1738,.464,579,1157,.500,227,581,.391,277,365,.759,2116,775,1651,.469,574,1111,.517,201,540,.372,297,388,.765,2048
72,BRK,2017-18,20,7,13,.350,4800,788,1777,.443,555,1104,.503,233,673,.346,395,537,.736,2204,838,1789,.468,632,1235,.512,206,554,.372,392,504,.778,2274
73,IND,2017-18,20,11,9,.550,4800,826,1728,.478,628,1233,.509,198,495,.400,315,412,.765,2165,832,1755,.474,619,1158,.535,213,597,.357,267,368,.726,2144
74,MEM,2017-18,20,7,13,.350,4800,716,1610,.445,531,1050,.506,185,560,.330,355,447,.794,1972,719,1628,.442,514,1053,.488,205,575,.357,378,481,.786,2021
75,NOP,2017-18,20,11,9,.550,4825,814,1704,.478,613,1115,.550,201,589,.341,336,443,.758,2165,804,1770,.454,582,1151,.506,222,619,.359,337,429,.786,2167
76,MIA,2017-18,20,10,10,.500,4825,747,1664,.449,516,1025,.503,231,639,.362,289,369,.783,2014,744,1687,.441,557,1189,.468,187,498,.376,371,476,.779,2046
77,ORL,2017-18,20,8,12,.400,4800,800,1723,.464,570,1121,.508,230,602,.382,315,429,.734,2145,831,1798,.462,637,1251,.509,194,547,.355,354,454,.780,2210
78,PHO,2017-18,20,7,13,.350,4825,789,1801,.438,622,1284,.484,167,517,.323,395,528,.748,2140,843,1815,.464,633,1253,.505,210,562,.374,419,560,.748,2315
79,POR,2017-18,20,12,8,.600,4825,749,1702,.440,567,1227,.462,182,475,.383,384,476,.807,2064,738,1698,.435,569,1188,.479,169,510,.331,338,452,.748,1983
80,SAC,2017-18,20,6,14,.300,4800,745,1698,.439,583,1277,.457,162,421,.385,250,339,.737,1902,775,1640,.473,524,1003,.522,251,637,.394,302,395,.765,2103
81,MIN,2017-18,20,12,8,.600,4825,795,1707,.466,631,1255,.503,164,452,.363,408,521,.783,2162,837,1721,.486,625,1133,.552,212,588,.361,279,368,.758,2165
82,SAS,2017-18,20,13,7,.650,4800,769,1696,.453,592,1202,.493,177,494,.358,318,403,.789,2033,760,1669,.455,580,1151,.504,180,518,.347,271,378,.717,1971
83,DEN,2017-18,20,11,9,.550,4800,792,1716,.462,578,1126,.513,214,590,.363,328,452,.726,2126,812,1709,.475,577,1099,.525,235,610,.385,270,359,.752,2129
84,UTA,2017-18,20,9,11,.450,4825,733,1659,.442,507,1060,.478,226,599,.377,334,404,.827,2026,735,1608,.457,538,1090,.494,197,518,.380,341,443,.770,2008
85,PHI,2017-18,20,12,8,.600,4800,813,1766,.460,602,1173,.513,211,593,.356,345,483,.714,2182,767,1769,.434,563,1148,.490,204,621,.329,422,552,.764,2160
86,WAS,2017-18,20,11,9,.550,4850,790,1704,.464,596,1176,.507,194,528,.367,375,482,.778,2149,770,1704,.452,582,1141,.510,188,563,.334,347,449,.773,2075
87,BOS,2017-18,20,17,3,.850,4825,732,1696,.432,509,1073,.474,223,623,.358,381,492,.774,2068,723,1673,.432,552,1148,.481,171,525,.326,297,399,.744,1914
88,CLE,2017-18,20,13,7,.650,4825,799,1685,.474,566,1045,.542,233,640,.364,387,475,.815,2218,817,1762,.464,579,1121,.517,238,641,.371,310,419,.740,2182
89,GSW,2017-18,20,15,5,.750,4800,875,1724,.508,625,1091,.573,250,633,.395,348,423,.823,2348,774,1813,.427,566,1202,.471,208,611,.340,368,485,.759,2124
90,HOU,2017-18,20,16,4,.800,4800,774,1676,.462,452,784,.577,322,892,.361,404,501,.806,2274,777,1698,.458,574,1135,.506,203,563,.361,311,412,.755,2068
91,ATL,2016-17,20,10,10,.500,4800,766,1688,.454,595,1169,.509,171,519,.329,317,452,.701,2020,769,1750,.439,581,1211,.480,188,539,.349,294,381,.772,2020
92,WAS,2016-17,20,7,13,.350,4875,798,1759,.454,638,1316,.485,160,443,.361,330,431,.766,2086,786,1683,.467,581,1150,.505,205,533,.385,364,511,.712,2141
93,CHI,2016-17,20,11,9,.550,4800,772,1755,.440,639,1341,.477,133,414,.321,401,494,.812,2078,774,1734,.446,593,1241,.478,181,493,.367,275,372,.739,2004
94,LAC,2016-17,20,15,5,.750,4850,770,1666,.462,571,1135,.503,199,531,.375,437,580,.753,2176,720,1672,.431,547,1199,.456,173,473,.366,361,462,.781,1974
95,BOS,2016-17,20,12,8,.600,4800,772,1717,.450,550,1101,.500,222,616,.360,328,417,.787,2094,758,1711,.443,578,1182,.489,180,529,.340,381,497,.767,2077
96,BRK,2016-17,20,5,15,.250,4850,754,1735,.435,525,1038,.506,229,697,.329,377,487,.774,2114,860,1822,.472,642,1237,.519,218,585,.373,349,451,.774,2287
97,DAL,2016-17,20,4,16,.200,4850,686,1668,.411,494,1073,.460,192,595,.323,282,355,.794,1846,719,1561,.461,523,1060,.493,196,501,.391,354,463,.765,1988
98,IND,2016-17,20,10,10,.500,4900,800,1749,.457,645,1308,.493,155,441,.351,328,417,.787,2083,780,1739,.449,584,1146,.510,196,593,.331,369,468,.788,2125
99,HOU,2016-17,20,13,7,.650,4850,806,1729,.466,526,989,.532,280,740,.378,335,445,.753,2227,792,1722,.460,592,1177,.503,200,545,.367,366,464,.789,2150
100,LAL,2016-17,20,10,10,.500,4800,794,1742,.456,614,1231,.499,180,511,.352,364,466,.781,2132,823,1734,.475,637,1186,.537,186,548,.339,359,480,.748,2191
101,MEM,2016-17,20,12,8,.600,4900,698,1651,.423,529,1151,.460,169,500,.338,379,481,.788,1944,685,1549,.442,502,1018,.493,183,531,.345,412,555,.742,1965
102,MIN,2016-17,20,6,14,.300,4825,759,1689,.449,592,1215,.487,167,474,.352,410,522,.785,2095,768,1638,.469,589,1120,.526,179,518,.346,397,512,.775,2112
103,CHO,2016-17,20,11,9,.550,4875,754,1716,.439,551,1142,.482,203,574,.354,392,531,.738,2103,786,1800,.437,574,1187,.484,212,613,.346,279,360,.775,2063
104,MIL,2016-17,20,11,9,.550,4825,773,1687,.458,606,1193,.508,167,494,.338,364,469,.776,2077,731,1711,.427,534,1091,.489,197,620,.318,377,476,.792,2036
105,DEN,2016-17,20,7,13,.350,4875,772,1780,.434,589,1274,.462,183,506,.362,398,536,.743,2125,817,1776,.460,647,1290,.502,170,486,.350,386,501,.770,2190
106,NOP,2016-17,20,7,13,.350,4875,767,1714,.447,611,1229,.497,156,485,.322,360,468,.769,2050,787,1782,.442,589,1211,.486,198,571,.347,336,424,.792,2108
107,MIA,2016-17,20,7,13,.350,4825,742,1719,.432,576,1220,.472,166,499,.333,292,436,.670,1942,728,1677,.434,567,1233,.460,161,444,.363,360,452,.796,1977
108,ORL,2016-17,20,8,12,.400,4800,701,1685,.416,542,1193,.454,159,492,.323,299,415,.720,1860,747,1708,.437,593,1238,.479,154,470,.328,299,394,.759,1947
109,OKC,2016-17,20,12,8,.600,4900,816,1777,.459,637,1263,.504,179,514,.348,349,477,.732,2160,794,1769,.449,617,1258,.490,177,511,.346,350,469,.746,2115
110,PHI,2016-17,20,4,16,.200,4900,732,1693,.432,516,1103,.468,216,590,.366,277,377,.735,1957,809,1758,.460,621,1229,.505,188,529,.355,349,475,.735,2155
111,PHO,2016-17,20,6,14,.300,4875,786,1779,.442,633,1317,.481,153,462,.331,402,532,.756,2127,810,1749,.463,612,1244,.492,198,505,.392,446,571,.781,2264
112,SAC,2016-17,20,7,13,.350,4875,743,1682,.442,581,1209,.481,162,473,.342,399,510,.782,2047,746,1643,.454,538,1074,.501,208,569,.366,397,519,.765,2097
113,DET,2016-17,20,10,10,.500,4800,784,1740,.451,652,1344,.485,132,396,.333,288,374,.770,1988,724,1673,.433,550,1168,.471,174,505,.345,328,419,.783,1950
114,TOR,2016-17,20,14,6,.700,4825,811,1693,.479,625,1214,.515,186,479,.388,408,502,.813,2216,743,1660,.448,550,1100,.500,193,560,.345,363,476,.763,2042
115,CLE,2016-17,20,15,5,.750,4800,779,1706,.457,503,1017,.495,276,689,.401,388,502,.773,2222,802,1791,.448,602,1228,.490,200,563,.355,286,374,.765,2090
116,NYK,2016-17,20,11,9,.550,4825,796,1782,.447,612,1269,.482,184,513,.359,310,398,.779,2086,767,1717,.447,590,1208,.488,177,509,.348,418,540,.774,2129
117,GSW,2016-17,20,17,3,.850,4850,873,1738,.502,629,1105,.569,244,633,.385,392,495,.792,2382,790,1819,.434,607,1263,.481,183,556,.329,366,477,.767,2129
118,SAS,2016-17,20,16,4,.800,4800,742,1608,.461,567,1171,.484,175,437,.400,400,488,.820,2059,744,1644,.453,570,1148,.497,174,496,.351,302,395,.765,1964
119,POR,2016-17,20,10,10,.500,4875,810,1761,.460,589,1153,.511,221,608,.363,374,467,.801,2215,814,1765,.461,620,1241,.500,194,524,.370,448,567,.790,2270
120,UTA,2016-17,20,11,9,.550,4800,727,1564,.465,542,1045,.519,185,519,.356,346,448,.772,1985,707,1654,.427,548,1203,.456,159,451,.353,320,425,.753,1893
121,BOS,2015-16,20,11,9,.550,4800,764,1758,.435,578,1192,.485,186,566,.329,341,436,.782,2055,714,1632,.438,570,1203,.474,144,429,.336,388,515,.753,1960
122,PHI,2015-16,20,1,19,.050,4800,674,1625,.415,501,1092,.459,173,533,.325,303,431,.703,1824,744,1696,.439,594,1270,.468,150,426,.352,403,497,.811,2041
123,BRK,2015-16,20,5,15,.250,4825,765,1734,.441,672,1420,.473,93,314,.296,288,383,.752,1911,770,1681,.458,567,1142,.496,203,539,.377,314,421,.746,2057
124,UTA,2015-16,20,10,10,.500,4825,724,1641,.441,567,1217,.466,157,424,.370,359,482,.745,1964,694,1553,.447,537,1118,.480,157,435,.361,380,503,.755,1925
125,DEN,2015-16,20,7,13,.350,4800,719,1688,.426,567,1233,.460,152,455,.334,343,447,.767,1933,758,1665,.455,572,1176,.486,186,489,.380,357,479,.745,2059
126,HOU,2015-16,20,9,11,.450,4875,712,1682,.423,519,1070,.485,193,612,.315,424,582,.729,2041,806,1723,.468,632,1229,.514,174,494,.352,354,476,.744,2140
127,LAL,2015-16,20,3,17,.150,4800,692,1698,.408,529,1186,.446,163,512,.318,383,489,.783,1930,780,1731,.451,600,1208,.497,180,523,.344,374,490,.763,2114
128,MIN,2015-16,20,8,12,.400,4850,731,1646,.444,623,1317,.473,108,329,.328,452,562,.804,2022,757,1699,.446,584,1186,.492,173,513,.337,352,476,.739,2039
129,MEM,2015-16,20,11,9,.550,4800,695,1638,.424,587,1286,.456,108,352,.307,430,512,.840,1928,704,1542,.457,513,1022,.502,191,520,.367,399,525,.760,1998
130,CHO,2015-16,20,12,8,.600,4825,747,1692,.441,557,1147,.486,190,545,.349,363,475,.764,2047,757,1713,.442,587,1214,.484,170,499,.341,291,383,.760,1975
131,MIA,2015-16,20,12,8,.600,4800,718,1564,.459,598,1181,.506,120,383,.313,364,506,.719,1920,704,1691,.416,561,1247,.450,143,444,.322,321,424,.757,1872
132,MIL,2015-16,20,7,13,.350,4850,713,1606,.444,573,1216,.471,140,390,.359,339,428,.792,1905,737,1629,.452,556,1140,.488,181,489,.370,401,527,.761,2056
133,NYK,2015-16,20,10,10,.500,4825,719,1707,.421,570,1265,.451,149,442,.337,364,445,.818,1951,708,1683,.421,580,1254,.463,128,429,.298,412,555,.742,1956
134,OKC,2015-16,20,12,8,.600,4850,802,1726,.465,644,1279,.504,158,447,.353,391,497,.787,2153,759,1748,.434,607,1319,.460,152,429,.354,376,504,.746,2046
135,SAS,2015-16,20,16,4,.800,4800,780,1671,.467,638,1286,.496,142,385,.369,275,355,.775,1977,692,1663,.416,574,1283,.447,118,380,.311,268,346,.775,1770
136,ORL,2015-16,20,11,9,.550,4900,779,1787,.436,616,1321,.466,163,466,.350,311,401,.776,2032,707,1674,.422,527,1128,.467,180,546,.330,396,525,.754,1990
137,WAS,2015-16,20,9,11,.450,4800,740,1673,.442,574,1185,.484,166,488,.340,374,494,.757,2020,780,1685,.463,580,1176,.493,200,509,.393,339,432,.785,2099
138,DAL,2015-16,20,11,9,.550,4825,737,1666,.442,575,1142,.504,162,524,.309,375,485,.773,2011,737,1709,.431,562,1166,.482,175,543,.322,360,486,.741,2009
139,PHO,2015-16,20,8,12,.400,4825,790,1752,.451,581,1223,.475,209,529,.395,336,450,.747,2125,795,1689,.471,609,1193,.510,186,496,.375,343,488,.703,2119
140,POR,2015-16,20,8,12,.400,4850,755,1697,.445,562,1157,.486,193,540,.357,332,451,.736,2035,749,1726,.434,590,1247,.473,159,479,.332,387,528,.733,2044
141,LAC,2015-16,20,11,9,.550,4800,748,1629,.459,597,1166,.512,151,463,.326,408,611,.668,2055,737,1699,.434,580,1240,.468,157,459,.342,404,527,.767,2035
142,SAC,2015-16,20,7,13,.350,4825,782,1736,.450,613,1282,.478,169,454,.372,364,500,.728,2097,806,1718,.469,612,1153,.531,194,565,.343,369,480,.769,2175
143,IND,2015-16,20,12,8,.600,4825,751,1702,.441,555,1215,.457,196,487,.402,387,515,.751,2085,744,1687,.441,575,1198,.480,169,489,.346,339,469,.723,1996
144,TOR,2015-16,20,12,8,.600,4800,711,1630,.436,553,1183,.467,158,447,.353,424,532,.797,2004,700,1640,.427,522,1140,.458,178,500,.356,349,444,.786,1927
145,ATL,2015-16,20,12,8,.600,4800,759,1660,.457,570,1126,.506,189,534,.354,340,422,.806,2047,757,1713,.442,575,1214,.474,182,499,.365,309,379,.815,2005
146,DET,2015-16,20,11,9,.550,4850,737,1758,.419,574,1243,.462,163,515,.317,331,505,.655,1968,747,1645,.454,594,1219,.487,153,426,.359,309,404,.765,1956
147,CHI,2015-16,20,12,8,.600,4850,738,1756,.420,577,1315,.439,161,441,.365,325,432,.752,1962,744,1823,.408,596,1372,.434,148,451,.328,318,442,.719,1954
148,CLE,2015-16,20,13,7,.650,4875,748,1666,.449,549,1101,.499,199,565,.352,334,465,.718,2029,732,1647,.444,587,1222,.480,145,425,.341,342,460,.743,1951
149,GSW,2015-16,20,20,0,1.000,4825,849,1723,.493,582,1107,.526,267,616,.433,341,448,.761,2306,748,1767,.423,622,1349,.461,126,418,.301,376,496,.758,1998
150,NOP,2015-16,20,5,15,.250,4825,756,1711,.442,580,1195,.485,176,516,.341,357,455,.785,2045,799,1729,.462,614,1256,.489,185,473,.391,397,490,.810,2180
